NO ./textures/north.xpm
SO ./textures/south.xpm
WE ./textures/west.xpm
EA ./textures/east.xpm

F 160,121,104
C 160,212,104

        1111111111111111111111111
        1004000000110000000000001
        1011000001110004040004001
        1001000000020000040000001
111111111011040001110004000000001
140000020011000001110111112111111
11110111111111011100000010001
11112111111111011101014010001
11000000110101011104000014001
10000040000400001100000010001
10040000000000001101014010001
11000401110101011121011110N01
11110111 1110101 141111010001
11111111 1111111 111111111111
