NO ./images/wall_n.xpm
SO ./images/wall_s.xpm
WE ./images/wall_w.xpm
EA ./images/wall_e.xpm

F 160,121,104
C 160,212,104

        1111111111111111111111111
        1000000000110000000000001
        1011000001110000000000001
        1001000000020000000000001
111111111011000001110000000000001
100000020011000001110111112111111
11110111111111011100000010001
11112111111111011101010010001
11000000110101011100000010001
10000000000000001100000010001
10000000000000001101010010001
11000001110101011121011110N01
11110111 1110101 101111010001
11111111 1111111 111111111111
