NO ./images/wall_n.xpm
SO ./images/wall_s.xpm
WE ./images/wall_w.xpm
EA ./images/wall_e.xpm

F 160,121,104
C 160,212,104

1111111111
10000000N1
1011110111
1001000001
1111011101
1000000101
1010111101
1000000101
1101110101
1111111111
