NO ./images/north.xpm
SO ./images/south.xpm
WE ./images/west.xpm
EA ./images/east.xpm

F 160,121,104
C 160,212,104

        1111111111111111111111111
        1000000000110000000000001
        1011000001110000000000001
        1001000000020000000000001
111111111011000001110000000000001
100000200011000001112111110111111
11110111111111011100000010001
11110111111111211101010010001
11000000110101011100000010001
10000000000000001100000010001
10000000000000001101010010001
11000001110101011111011110N01
11110111 1110101 101111010001
11111111 1111111 11111111111