NO ./textures/wall_n.xpm
SO ./textures/wall_s.xpm
WE ./textures/wall_w.xpm
EA ./textures/wall_e.xpm

F 160,121,104
C 160,212,104

      111111  1 1 11111
 11111000000110111100001   
10000000001000000100001
100000000000000110000101
 11111000000000000000001
    1000000000000000001
    100000000000000001   
     11111100000000E1
           1100000001
            10000001     
             1111001  
                 1001 1111111 
                  100100000001      
                 100000000000011
                10000000000000001
                10000000000000001
                 110000000000001  
                   100000000001
                   10000000001    
                    1000000001
                     100000001  
                      1000001
                       10001
                        1001
                         11