NO ./textures/wall_n.xpm
SO ./textures/wall_s.xpm
WE ./textures/wall_w.xpm
EA ./textures/wall_e.xpm

F 160,121,104
C 160,212,104

 11111 1 1
10000010101
 1010000001
1000000011
 1111111   
       
  11111111 
 10000W0101
1001000001   
10010001001  
111 111 1  