NO ./textures/wall_n.xpm
SO ./textures/wall_s.xpm
WE ./textures/wall_w.xpm
EA ./textures/wall_e.xpm

F 160,121,104
C 160,212,104

 11111 1 1      11111 11
10000010101    1000001001  
 1010000001     100000001
1000000011       1100001       
 1111111           10001   
                   1001       11111
                    101      1011
                     1        1101
                              1111
              1 
             100
             111
           
  11111111     
 10000W0101
1001000001   
10010001001  
101 111 11
 1